F    80, 60, 30
C 30  ,  0,10


NO ./textures/wall_0.xpm
SO ./textures/wall_3.xpm
WE ./textures/wall_6.xpm
EA ./textures/wall_10.xpm


                               111
        11111111111111111111111101
        100000000000000000000000S1
        1011000000000000000000001
        1011000000000000000000001
        1011000000000000000000001
        1011000000000000000000001
        1011000000000000000000001
        1011000000000000000000001
        1001000000000000000000001
111111111011000001110000000000001
100000000011000001110111111111111
1111011111111101110000001
11111111111111011101010011111
11000000110101011100000010001
10000000000000001100000010001
10000000000000001101010010001
11000001110101011111011110011
11110111 1110101 101111010001
11111111 1111111 111111111111
11111111111111111111111111111
